kreiskey1883,county,rb,land1882_far_ext_un1,land1882_far_ext_1to2,land1882_far_ext_2to10,land1882_far_ext_10to50,land1882_far_ext_50to100,land1882_far_ext_ov100,land1882_far_ext_tot,land1882_area_ext_un1,land1882_area_ext_1to2,land1882_area_ext_2to10,land1882_area_ext_10to50,land1882_area_ext_50to100,land1882_area_ext_ov100,land1882_area_ext_tot
1,"MEMEL","KON",973,386,1338,942,58,60,3757,396,881,9125,27491,5371,17202,60466
2,"FISCHHAUSEN","KON",1153,145,520,515,152,168,2653,324,227,3079,18966,12328,49855,84779
3,"KONIGSBERG STADTKREIS","KON",100,18,31,15,0,2,166,26,24,116,235,0,394,795
4,"KONIGSBERG LANDKREIS","KON",2306,242,465,509,210,183,3915,524,377,2666,15016,16188,60677,95448
5,"LABIAU","KON",2776,1224,1708,570,99,70,6447,844,1981,8048,13531,8007,22358,54769
6,"WEHLAU","KON",3632,251,597,732,128,101,5441,821,359,3135,21355,9387,42456,77513
7,"GERDAUEN","KON",3174,240,401,539,88,106,4548,775,332,2110,15273,6896,57511,82897
8,"RASTENBURG","KON",4387,146,291,458,130,130,5542,1044,208,1702,13172,9809,56313,82248
9,"FRIEDLAND","KON",2686,185,351,516,91,132,3961,752,259,2006,14641,7006,58230,82894
10,"PREUSSISCH EYLAU","KON",2600,402,1007,1057,148,150,5364,774,588,5965,27722,11112,70200,116361
11,"HEILIGENBEIL","KON",2124,349,837,814,156,103,4383,609,504,4702,22061,12047,43446,83369
12,"BRAUNSBERG","KON",1185,1119,1051,992,427,34,4808,560,1306,5304,35274,31389,9218,83051
13,"HEILSBERG","KON",1586,781,1583,1627,316,46,5939,704,1106,8246,51439,22698,11777,95970
14,"ROSSEL","KON",1519,531,1076,1297,159,52,4634,525,785,5815,36970,11711,15380,71186
15,"ALLENSTEIN","KON",2267,612,1797,1523,228,71,6498,802,982,9744,43936,16522,20376,92362
16,"ORTELSBURG","KON",2342,764,2045,2116,210,73,7550,824,1147,11507,63825,15594,25797,118694
17,"NEIDENBURG","KON",2082,730,1096,1472,312,131,5823,701,1023,6393,45147,22045,50893,126202
18,"OSTERODE","KON",3099,780,1365,1195,162,127,6728,1236,1138,7889,32549,12249,65915,120976
19,"MOHRUNGEN","KON",3231,639,1118,967,120,128,6203,1121,952,5984,24522,8822,61715,103116
20,"PREUSSISCH HOLLAND","KON",2754,396,929,886,139,88,5192,811,589,5022,24828,9484,35416,76150
21,"HEYDEKRUG","GUM",2252,1051,2088,969,44,20,6424,1170,2122,14018,25100,3255,6625,52290
22,"NIEDERUNG","GUM",2549,886,2250,1285,108,40,7118,853,1508,11819,33608,7160,8172,63120
23,"TILSIT LANDKREIS","GUM",2071,862,2244,1262,83,46,6568,687,1641,13100,30145,5959,18600,70132
24,"RAGNIT","GUM",2399,650,2120,1268,148,101,6686,711,1161,11321,33873,12292,30923,90281
25,"PILLKALLEN","GUM",1993,580,1720,1093,215,103,5704,560,921,8381,32806,16985,24976,84629
26,"STALLUPONEN","GUM",1852,601,1262,999,121,60,4895,588,931,6114,27240,8316,16585,59774
27,"GUMBINNEN","GUM",2032,422,936,941,134,81,4546,633,645,4437,25720,9690,21828,62953
28,"INSTERBURG","GUM",2797,640,1449,1119,192,127,6324,911,940,7541,29150,14998,33724,87264
29,"DARKEHMEN","GUM",1989,328,843,587,100,105,3952,540,497,4397,15792,7376,41184,69786
30,"ANGERBURG","GUM",2032,360,855,707,137,101,4192,601,524,4565,21550,10369,31496,69105
31,"GOLDAP","GUM",1910,683,1455,1289,87,54,5478,635,1041,7804,34532,6740,18770,69522
32,"OLETZKO","GUM",1815,550,1007,1122,118,67,4679,599,868,5158,31944,8831,23720,71120
33,"LYCK","GUM",2676,569,1070,1448,160,84,6007,1002,853,5943,46193,12437,23359,89787
34,"LOTZEN","GUM",1766,449,770,808,196,93,4082,602,638,4279,26230,14239,24783,70771
35,"SENSBURG","GUM",3841,677,1151,1011,136,101,6917,1167,974,6369,28081,10183,37272,84046
36,"JOHANNISBURG","GUM",1589,576,1201,1461,167,61,5055,561,908,7456,44918,13440,22532,89815
37,"ELBING STADTKREIS","DAN",731,40,62,21,2,2,858,109,53,301,1232,107,2923,4725
38,"ELBING LANDKREIS","DAN",2359,386,1000,845,91,37,4718,664,942,6002,22852,7023,10030,47513
39,"MARIENBURG IN PREUSSEN","DAN",3919,314,801,877,338,108,6357,699,495,4391,23785,23860,16611,69841
40,"DANZIG STADTKREIS","DAN",319,46,43,15,1,1,425,85,62,202,301,57,120,827
41,"DANZIG LANDKREIS","DAN",6603,505,907,945,226,131,9317,1747,753,4968,24379,16347,34753,82947
42,"PREUSSISCH STARGARD","DAN",4146,531,873,839,151,146,6686,1363,847,5478,21598,11252,56430,96968
43,"BERENT","DAN",2063,492,1191,1180,127,102,5155,970,783,8461,36128,12275,41158,99775
44,"KARTHAUS","DAN",2822,1098,3129,1453,102,111,8715,1223,1625,20752,34711,8768,43939,111018
45,"NEUSTADT IN WESTPREUSSEN","DAN",3344,1043,1581,1110,107,122,7307,1385,1537,10757,29246,9211,59070,111206
46,"STUHM","MAR",2547,352,449,546,126,110,4130,749,529,2213,14812,8557,29553,56413
47,"MARIENWERDER","MAR",3029,681,914,681,156,119,5580,1031,995,4447,18165,11552,46418,82608
48,"ROSENBERG IN WESTPREUSSEN","MAR",3566,417,710,669,63,92,5517,1165,868,4030,15314,4580,61869,87826
49,"LOBAU","MAR",2535,607,1139,1114,158,97,5650,1003,903,5709,26370,11544,35636,81165
50,"STRASBURG","MAR",3422,970,1725,1204,96,133,7550,1263,1430,9142,28537,5921,60521,106814
51,"THORN LANDKREIS","MAR",3264,701,1298,745,103,130,6241,1104,1120,6639,19327,7200,54944,90334
52,"KULM","MAR",3199,643,1111,595,82,127,5757,1002,1003,5483,14598,4975,54230,81291
53,"GRAUDENZ LANDKREIS","MAR",2962,574,796,659,120,114,5225,1016,864,3811,17856,7582,43306,74435
54,"SCHWETZ","MAR",4097,1241,2169,1132,111,99,8849,1513,2027,11594,28984,9140,58365,111623
55,"TUCHEL","MAR",1282,342,702,548,90,64,3028,496,564,3805,14467,6817,23317,49466
56,"KONITZ","MAR",1917,562,912,913,239,60,4603,768,995,7298,37394,26239,33759,106453
57,"SCHLOCHAU","MAR",2535,1172,1649,1399,297,211,7263,1100,1639,11867,45360,24978,74128,159072
58,"FLATOW","MAR",3044,952,2121,1645,204,122,8088,1261,1398,11408,44351,15158,53053,126629
59,"DEUTSCH KRONE","MAR",3204,689,1073,1584,255,202,7007,1201,1153,6955,51451,21033,101404,183197
60,"BERLIN","BER",1530,56,110,35,6,2,1739,198,85,527,705,351,405,2271
61,"PRENZLAU","POT",4862,440,437,579,224,141,6683,1339,622,2109,17825,14921,67564,104380
62,"TEMPLIN","POT",4757,771,905,775,126,112,7446,1998,1196,5312,22643,9499,48104,88752
63,"ANGERMUNDE","POT",6233,881,1242,1093,84,76,9609,2115,1298,6380,26166,5916,43989,85864
64,"OBERBARNIM","POT",6258,553,924,1047,157,74,9013,1619,881,4859,27354,11569,51282,97564
65,"NIEDERBARNIM","POT",7570,1269,1791,1487,222,74,12413,2568,2030,10063,47581,16858,29863,108963
66,"CHARLOTTENBURG","POT",166,40,56,8,0,1,271,47,57,274,160,0,200,738
67,"TELTOW","POT",5476,1274,2292,1551,120,72,10785,2006,2155,13546,51557,8974,32601,110839
68,"BEESKOW-STORKOW","POT",2467,1142,1614,1004,46,52,6325,1323,2160,9008,32331,5496,25759,76077
69,"JUTERBOG-LUCKENWALDE","POT",4473,1136,1893,1274,209,40,9025,1575,1788,11049,50358,16696,17971,99437
70,"ZAUCH-BELZIG","POT",4842,1962,2984,1633,334,73,11828,2005,2963,15699,56919,28373,39909,145868
71,"POTSDAM","POT",132,42,51,4,0,0,229,65,60,202,72,0,0,399
72,"OSTHAVELLAND","POT",5032,526,1030,1198,205,71,8062,1503,877,5720,40091,15428,31831,95450
73,"BRANDENBURG","POT",117,34,125,69,5,1,351,55,60,653,1372,324,151,2615
74,"WESTHAVELLAND","POT",4592,623,836,1004,217,75,7347,1639,1033,4811,35081,16642,45895,105101
75,"RUPPIN","POT",5611,1282,1735,1789,214,101,10732,2275,2356,9899,52375,16618,52088,135611
76,"OSTPRIGNITZ","POT",4418,1315,1858,2236,283,132,10242,3207,2068,12285,66194,22675,51497,157926
77,"WESTPRIGNITZ","POT",6218,1495,1923,1937,113,89,11775,2234,2361,9943,60815,8409,39675,123437
78,"KONIGSBERG IN NEUMARK","FRA",6353,1178,1798,1575,122,87,11113,2184,1723,9044,36064,9546,59659,118220
79,"SOLDIN","FRA",3888,567,901,810,95,93,6354,1183,813,4540,18321,6483,59290,90630
80,"ARNSWALDE","FRA",2419,649,756,912,111,101,4948,833,920,4038,26122,8334,62617,102864
81,"FRIEDEBERG","FRA",3332,836,1808,1098,34,48,7156,1220,1388,11205,27405,3190,35867,80275
82,"LANDSBERG LANDKREIS","FRA",3497,1337,2560,1293,55,35,8777,1372,2130,14406,27350,3746,31761,80765
83,"LEBUS","FRA",8059,951,1459,1681,222,105,12477,2354,1396,8212,40686,17344,59017,129009
84,"FRANKFURT","FRA",390,87,123,41,6,5,652,122,119,479,721,363,1366,3170
85,"WESTSTERNBERG","FRA",3619,825,1235,1081,184,52,6996,1279,1290,7758,30480,14433,30968,86208
86,"OSTSTERNBERG","FRA",2840,643,1393,1187,79,55,6197,1023,1199,9340,33750,7734,32706,85752
87,"ZULLICHAU-SCHWIEBUS","FRA",2209,465,1449,980,27,71,5201,721,702,8401,28053,2398,45173,85448
88,"KROSSEN","FRA",3011,1076,2435,1233,14,45,7814,1433,2066,19250,36325,1427,37559,98060
89,"GUBEN LANDKREIS","FRA",3605,1167,2373,1231,25,39,8440,2047,2725,16684,36730,2818,19953,80957
90,"LUBBEN","FRA",1623,859,1779,1004,62,29,5356,829,1369,11862,33779,5560,17647,71046
91,"LUCKAU","FRA",3625,1360,2762,1482,45,48,9322,1680,2312,20463,46877,4000,35158,110490
92,"KALAU","FRA",3171,1250,2599,943,15,72,8050,1567,2183,20187,25732,2425,32849,84943
93,"KOTTBUS LANDKREIS","FRA",2636,1670,3352,776,7,36,8477,1513,3003,23357,18519,748,15414,62554
94,"SORAU","FRA",3524,1361,2910,988,42,79,8904,1768,3116,22722,28795,5006,27368,88775
95,"SPREMBERG","FRA",1088,592,864,167,2,18,2731,544,1187,7841,5530,387,8966,24455
96,"DEMMIN","STE",5837,431,714,553,133,109,7777,1281,538,3549,13305,8228,61559,88460
97,"ANKLAM","STE",1933,236,384,412,71,69,3105,450,371,1948,10805,4887,40179,58640
98,"USEDOM-WOLLIN","STE",2353,788,1553,549,37,34,5314,809,1186,7707,12091,2940,17825,42558
99,"UCKERMUNDE","STE",3006,951,1374,481,33,26,5871,1062,1410,6326,10812,2786,14803,37199
100,"RANDOW","STE",4001,811,1753,1097,162,107,7931,1504,1750,12199,32789,12480,59425,120147
101,"STETTIN","STE",361,26,33,23,0,2,445,100,46,168,572,0,517,1403
102,"GREIFENHAGEN","STE",3011,655,1525,1045,90,56,6382,1131,972,8153,30133,6358,23553,70300
103,"PYRITZ","STE",3059,294,555,911,131,101,5051,912,440,3013,26367,8747,56300,95779
104,"SAATZIG","STE",3650,739,1591,1449,131,95,7655,1385,1078,8427,38570,8362,48810,106632
105,"NAUGARD","STE",2112,852,2420,1338,79,87,6888,767,1226,13912,33785,6218,35167,91075
106,"KAMMIN","STE",2775,693,1543,795,72,106,5984,821,1070,9170,21526,5330,54818,92735
107,"GREIFENBERG","STE",1854,333,995,768,97,62,4109,599,514,5331,24445,6788,28750,66427
108,"REGENWALDE","STE",3024,582,1072,844,38,143,5703,899,868,5785,20400,2829,81910,112691
109,"SCHIVELBEIN","KOS",1016,347,667,405,53,53,2541,317,516,3569,11859,4316,25336,45913
110,"DRAMBURG","KOS",2654,468,801,733,156,103,4915,1522,663,4227,21318,12696,59694,100120
111,"NEUSTETTIN","KOS",3278,1097,2383,1679,182,182,8801,1486,1777,14197,45548,15840,95560,174408
112,"BELGARD","KOS",2884,616,1314,704,31,112,5661,1224,875,8350,18585,2420,72762,104216
113,"KOLBERG-KORLIN","KOS",2323,574,1274,813,89,83,5156,650,821,7231,21387,6783,48928,85800
114,"KOSLIN","KOS",1967,635,1341,667,16,61,4687,740,1071,7494,16818,941,35902,62966
115,"BUBLITZ","KOS",1275,469,599,421,43,60,2867,555,622,3179,11668,3318,42679,62021
116,"SCHLAWE","KOS",3708,1912,3340,1428,51,89,10528,1834,2832,17558,37620,4059,68138,132041
117,"RUMMELSBURG","KOS",1975,1226,1141,588,26,91,5047,925,1531,6428,13274,2334,74055,98547
118,"STOLP LANDKREIS","KOS",4592,2804,2861,1402,45,195,11899,2127,3883,15987,32113,3480,142447,200037
119,"LAUENBURG IN POMMERN","KOS",2503,1568,996,563,45,119,5794,1108,2112,6127,16508,6718,82012,114585
120,"BUTOW","KOS",1077,524,686,503,60,54,2904,481,796,4594,15355,5191,18237,44654
121,"RUGEN","STR",5547,689,840,539,55,189,7859,901,1104,3746,13199,3861,58472,81283
122,"STRALSUND","STR",257,37,92,30,1,1,418,73,58,482,445,77,542,1677
123,"FRANZBURG","STR",4927,774,552,327,40,154,6774,1543,1231,2683,8241,3103,71376,88177
124,"GREIFSWALD","STR",4139,308,437,218,87,172,5361,994,452,2119,4602,6807,68816,83790
125,"GRIMMEN","STR",4163,505,560,344,115,161,5848,886,777,2475,8600,8547,61961,83246
126,"WRESCHEN","POS",2650,205,692,615,38,99,4299,975,298,4235,11638,3660,46039,66845
127,"PLESCHEN","POS",3875,363,1916,706,19,102,6981,1394,524,11977,11934,1269,72299,99397
128,"SCHRODA","POS",2989,303,712,1154,58,147,5363,1065,444,4392,23215,4481,65024,98621
129,"SCHRIMM","POS",3016,436,1032,1182,23,96,5785,1006,673,6313,24738,1751,56371,90852
130,"KOSTEN","POS",4282,898,1678,1402,42,117,8419,1647,1370,9498,24533,2930,65846,105824
131,"BUK","POS",2792,592,1619,1320,24,62,6409,1020,992,9950,24281,1752,44759,82754
132,"POSEN STADTKREIS","POS",66,6,9,4,2,2,89,18,9,57,108,189,490,871
133,"POSEN LANDKREIS","POS",3606,403,659,1037,61,126,5892,1066,565,3699,21528,4444,68038,99340
134,"OBORNIK","POS",3027,399,588,1039,92,101,5246,913,758,2467,24704,5954,51624,86420
135,"SAMTER","POS",3452,367,745,884,21,97,5566,1208,532,4307,18421,1570,58382,84420
136,"BIRNBAUM","POS",1940,221,657,1160,94,67,4139,696,491,4156,30463,7738,46950,90494
137,"MESERITZ","POS",2058,424,1208,1579,76,59,5404,769,657,8607,43231,6712,45607,105583
138,"BOMST","POS",1903,906,2414,1504,28,47,6802,839,1440,14988,30731,2374,38809,89181
139,"FRAUSTADT","POS",2494,543,1892,1320,27,80,6356,833,808,10865,28036,2232,45675,88449
140,"KROBEN","POS",3409,1023,2940,1128,22,98,8620,1362,1483,16570,17850,1680,55434,94379
141,"KROTOSCHIN","POS",2350,719,2520,1105,37,83,6814,850,1076,14708,18808,2710,42101,80253
142,"ADELNAU","POS",2194,986,2693,931,14,59,6877,962,1476,15198,15664,1607,31814,66721
143,"SCHILDBERG","POS",2379,935,3207,1035,31,77,7664,961,1398,18525,17441,2364,39488,80177
144,"CZARNIKAU","BRO",3658,818,2402,1661,118,77,8734,1298,1332,13221,44472,9991,39187,109501
145,"KOLMAR","BRO",2028,558,1554,1015,75,65,5295,1077,879,9131,27202,6650,32358,77297
146,"WIRSITZ","BRO",3500,459,1121,971,102,129,6282,1224,716,6173,23286,7427,68498,107324
147,"BROMBERG STADTKREIS","BRO",231,14,12,4,5,1,267,80,18,59,89,405,137,788
148,"BROMBERG LANDKREIS","BRO",2910,1008,1505,881,147,129,6580,1105,1700,7813,22786,12042,47241,92687
149,"SCHUBIN","BRO",2909,599,1605,844,76,121,6154,1077,999,8064,20220,5850,75818,112028
150,"INOWRAZLAW","BRO",4720,629,1337,1049,77,214,8026,1727,946,7013,25865,5661,92360,133572
151,"MOGILNO","BRO",3053,451,648,736,158,142,5188,1066,635,3073,18919,11446,54360,89499
152,"GNESEN","BRO",3008,346,699,1118,79,166,5416,1011,504,3836,25437,5553,68358,104699
153,"WONGROWITZ","BRO",4946,294,579,1042,96,161,7118,1901,399,3149,23436,7343,86268,122496
154,"NAMSLAU","BRE",1170,483,1264,557,37,52,3563,409,833,6282,12410,2537,29888,52359
155,"WARTENBERG","BRE",2344,1445,2457,749,10,52,7057,917,1930,11523,13853,680,28695,57598
156,"OLS","BRE",2301,839,2231,758,37,99,6265,830,1263,11319,16976,2307,41691,74386
157,"TREBNITZ","BRE",2613,983,2128,838,48,98,6708,980,1470,10170,18377,3345,36783,71125
158,"MILITSCH","BRE",2131,835,2435,812,17,73,6303,765,1192,13108,15840,1917,30066,62888
159,"GUHRAU","BRE",1390,365,1704,673,29,69,4230,441,553,8872,13848,2161,33176,59051
160,"STEINAU","BRE",782,205,999,371,10,55,2422,248,331,5286,8806,857,22701,38229
161,"WOHLAU","BRE",1808,544,2488,640,28,94,5602,675,855,12482,16023,2483,34694,67212
162,"NEUMARKT","BRE",2706,589,2045,514,63,106,6023,1025,883,9686,13477,4294,39862,69227
163,"BRESLAU STADTKREIS","BRE",325,56,139,8,2,4,534,108,81,643,142,168,1638,2780
164,"BRESLAU LANDKREIS","BRE",3214,674,2222,539,61,136,6846,1084,989,10140,12426,4198,39874,68711
165,"OHLAU","BRE",2139,598,2084,880,61,43,5805,806,710,10314,20035,4220,18635,54720
166,"BRIEG","BRE",1645,508,1853,989,39,25,5059,655,743,9735,22509,2587,7603,43832
167,"STREHLEN","BRE",1068,291,1130,350,35,51,2925,319,435,5154,7912,2459,14397,30676
168,"NIMPTSCH","BRE",874,378,891,238,52,71,2504,296,441,3978,6649,3644,20243,35251
169,"MUNSTERBERG","BRE",882,351,1226,461,37,44,3001,321,556,5537,10776,2562,10000,29752
170,"FRANKENSTEIN","BRE",1450,542,1828,740,32,30,4622,578,861,8933,17584,2686,10876,41518
171,"REICHENBACH","BRE",1566,285,1071,488,17,34,3461,523,492,5067,11254,1179,12766,31281
172,"SCHWEIDNITZ LANDKREIS","BRE",2169,469,1607,721,60,77,5103,677,707,7555,18303,4355,18860,50457
173,"STRIEGAU","BRE",1264,152,830,275,50,44,2615,341,231,4016,7263,3504,14276,29631
174,"WALDENBURG","BRE",1707,484,1249,720,7,6,4173,639,818,7185,14582,930,1744,25898
175,"GLATZ","BRE",1696,951,1918,740,26,30,5361,826,1556,9290,18535,1853,8463,40523
176,"NEURODE","BRE",1081,844,1624,408,10,15,3982,582,1316,7612,9243,1861,5473,26087
177,"HABELSCHWERDT","BRE",1572,1064,2846,1199,33,9,6723,641,1794,16597,28460,2596,8655,58743
178,"GRUNBERG","LIE",2940,1088,2332,766,5,33,7164,1319,1871,15419,20149,389,27717,66864
179,"FREISTADT","LIE",1864,611,1977,984,28,56,5520,666,868,10963,23185,2316,27257,65255
180,"SAGAN","LIE",1806,1010,2624,870,41,53,6404,964,2110,17931,30574,4390,23700,79669
181,"SPROTTAU","LIE",930,381,1472,628,37,38,3486,388,613,7722,16883,2936,22337,50879
182,"GLOGAU","LIE",1926,575,2559,1203,31,88,6382,579,812,13424,26470,2316,38392,81993
183,"LUBEN","LIE",1189,317,1523,479,14,62,3584,376,498,8004,10926,1666,34710,56180
184,"BUNZLAU","LIE",1733,1074,2859,834,54,38,6592,852,1623,15372,24771,5002,18465,66085
185,"GOLDBERG-HAINAU","LIE",1618,594,1953,609,110,75,4959,641,812,9347,15594,9089,22140,57623
186,"LIEGNITZ STADTKREIS","LIE",120,23,84,49,1,1,278,319,29,466,709,59,118,1700
187,"LIEGNITZ LANDKREIS","LIE",2565,534,1773,569,88,94,5623,937,852,8980,14101,5839,24948,55657
188,"JAUER","LIE",1354,269,936,365,34,30,2988,370,465,4342,9555,2418,11378,28528
189,"SCHONAU","LIE",939,389,1341,469,10,22,3170,472,608,7077,13329,952,8471,30909
190,"BOLKENHAIN","LIE",1070,435,1435,477,16,26,3459,415,707,7319,12170,1205,8493,30309
191,"LANDESHUT","LIE",1166,637,1608,713,15,8,4147,558,873,8253,16123,1088,4161,31056
192,"HIRSCHBERG","LIE",2322,997,2048,537,19,14,5937,949,1551,10279,13619,1721,6793,34912
193,"LOWENBERG","LIE",3235,1529,3702,963,68,23,9520,1363,2279,17252,25778,6403,5172,58247
194,"LAUBAN","LIE",3295,1440,2845,604,27,48,8259,1556,2084,12692,14455,2075,12914,45776
195,"GORLITZ STADTKREIS","LIE",81,18,70,26,5,4,204,35,32,400,589,355,3226,4637
196,"GORLITZ LANDKREIS","LIE",1971,924,2686,836,46,50,6513,912,1341,12880,22324,3719,12461,53637
197,"ROTHENBURG","LIE",2811,1407,3075,495,11,61,7860,1366,2403,19961,12593,1288,29207,66818
198,"HOYERSWERDA","LIE",1557,940,2446,713,7,17,5680,828,2079,21109,19878,753,12862,57509
199,"KREUZBURG","OPP",1764,501,1457,556,23,49,4350,535,693,6826,11355,1636,29229,50274
200,"ROSENBERG IN OBERSCHLESIEN","OPP",2220,1167,2420,653,4,40,6504,999,1607,13347,11939,252,30203,58347
201,"OPPELN LANDKREIS","OPP",4774,2766,4868,1625,19,26,14078,2317,4025,24735,28331,1296,13868,74572
202,"GROSS STREHLITZ","OPP",2467,1703,2499,760,9,40,7478,1213,2438,11669,13945,627,26863,56755
203,"LUBLINITZ","OPP",1487,1354,2790,523,10,32,6196,743,1956,14176,9919,605,44115,71514
204,"TOST-GLEIWITZ","OPP",3849,1724,3394,576,9,51,9603,1525,2495,17829,10495,657,33607,66608
205,"TARNOWITZ","OPP",2827,1224,1062,77,2,19,5211,1225,1726,4231,1377,149,11927,20635
206,"BEUTHEN LANDKREIS","OPP",2592,540,569,80,0,8,3789,890,742,2530,1219,0,2806,8187
207,"ZABRZE","OPP",2036,456,627,42,0,8,3169,766,643,2679,652,0,3453,8193
208,"KATTOWITZ LANDKREIS","OPP",3312,687,727,64,1,9,4800,1214,1103,3373,1096,70,2913,9769
209,"PLESS","OPP",5221,3305,4464,1030,22,43,14085,2705,4690,21079,21462,1560,19680,71176
210,"RYBNIK","OPP",3235,2778,4667,528,19,63,11290,1675,4113,21365,10438,1833,21140,60564
211,"RATIBOR","OPP",6984,2824,3643,917,12,71,14451,2953,4169,17754,15331,1479,32226,73912
212,"KOSEL","OPP",3223,1488,2406,669,6,50,7842,1349,2184,11230,11201,467,22388,48819
213,"LEOBSCHUTZ","OPP",3306,1200,3186,1557,33,28,9310,1245,1794,15300,36589,2207,6540,63675
214,"NEUSTADT IN OBERSCHLESIEN","OPP",3234,1404,3295,1543,19,40,9535,1308,2298,15103,27568,1276,22163,69716
215,"FALKENBERG","OPP",1365,545,2208,622,9,50,4799,556,811,11943,10640,1192,25246,50388
216,"NEISSE","OPP",1777,903,2963,1640,38,39,7360,763,1404,14339,34925,2909,8329,62669
217,"GROTTKAU","OPP",972,296,1855,955,16,56,4150,350,443,9934,21427,1214,17622,50990
218,"OSTERBURG","MAG",4169,774,1345,1235,235,113,7871,1458,1178,7542,41089,18988,30318,100573
219,"SALZWEDEL","MAG",2651,1449,2586,1663,190,22,8561,1180,2206,13128,64115,16939,7468,105036
220,"GARDELEGEN","MAG",3329,1568,2599,1289,160,32,8977,1487,2485,14274,47606,15621,19774,101247
221,"STENDAL","MAG",4576,675,1101,1458,120,35,7965,1496,1040,5800,43148,9101,15361,75946
222,"JERICHOW I","MAG",5164,1205,1696,1385,159,85,9694,2193,1797,9100,40843,12972,39961,106866
223,"JERICHOW II","MAG",5273,1135,1513,1488,142,69,9620,2347,1746,9119,52015,11346,39630,116203
224,"KALBE","MAG",6979,1066,1241,541,34,32,9893,2537,1463,5845,11244,2316,20413,43818
225,"WANZLEBEN","MAG",8109,1318,1242,372,22,55,11118,2948,1828,5756,7171,1617,35677,54997
226,"MAGDEBURG","MAG",632,58,109,89,2,5,895,172,94,603,1731,167,1013,3780
227,"WOLMIRSTEDT","MAG",5684,1296,1319,729,42,38,9108,2472,1795,8368,19136,3976,16950,52697
228,"NEUHALDENSLEBEN","MAG",6227,850,1136,685,65,52,9015,2393,1282,5529,15033,4854,25042,54133
229,"OSCHERSLEBEN","MAG",5490,911,1165,454,30,36,8086,2074,1281,5556,9236,2119,21368,41634
230,"ASCHERSLEBEN","MAG",4700,967,1278,345,60,39,7389,1759,1348,6094,6745,4790,15728,36464
231,"HALBERSTADT LANDKREIS","MAG",3581,1003,1498,639,58,37,6816,1515,1398,7509,13022,3963,13706,41113
232,"WERNIGERODE","MAG",2024,337,701,174,5,11,3252,695,493,3553,3008,327,3307,11383
233,"LIEBENWERDA","MER",2690,976,2288,1297,41,31,7323,1079,1525,13224,33256,3107,10369,62560
234,"TORGAU","MER",2258,687,1743,1174,86,56,6004,913,1022,9190,29583,5829,14139,60676
235,"SCHWEINITZ","MER",2430,904,2137,1380,109,38,6998,1048,1382,11735,44754,10716,13717,83352
236,"WITTENBERG","MER",2464,836,1734,985,202,23,6244,1073,1245,9861,30809,16739,8993,68720
237,"BITTERFELD","MER",3856,809,1555,777,78,44,7119,1562,1242,8840,18823,6097,13431,49995
238,"SAALKREIS","MER",7972,809,819,557,87,79,10323,2294,1131,4087,13689,5994,20320,47515
239,"HALLE","MER",64,11,11,8,3,3,100,19,16,53,278,218,795,1379
240,"DELITZSCH","MER",2623,579,1217,1300,134,66,5919,909,929,6755,31838,9776,17192,67399
241,"MANSFELDER GEBIRGSKR","MER",4975,832,1250,413,31,40,7541,2210,1259,6288,8899,3933,11975,34564
242,"MANSFELDER SEEKREIS","MER",6549,906,936,399,127,85,9002,2295,1298,4386,9646,8873,26629,53127
243,"SANGERHAUSEN","MER",6411,1508,2570,688,35,59,11271,2696,2195,12147,12836,2395,18549,50818
244,"ECKARTSBERGA","MER",2753,1007,1984,775,28,47,6594,1258,1384,11285,17214,2011,12435,45587
245,"QUERFURT","MER",4638,1039,1859,1011,69,54,8670,1793,1536,9397,21989,5643,18646,59004
246,"MERSEBURG","MER",4229,689,1628,1125,62,59,7792,1348,995,8849,23347,4380,14172,53091
247,"WEISSENFELS LANDKREIS","MER",4009,684,1594,1029,45,40,7401,1367,1058,9752,20850,3219,10143,46389
248,"NAUMBURG","MER",1397,246,633,333,8,8,2625,392,376,3704,6379,1259,1887,13997
249,"ZEITZ LANDKREIS","MER",2529,283,652,536,33,21,4054,729,442,3382,11700,2330,3920,22503
250,"NORDHAUSEN STADTKREIS","ERF",211,22,32,21,4,1,291,46,30,170,526,291,311,1374
251,"NORDHAUSEN LANDKREIS","ERF",3113,892,1358,473,45,40,5921,1441,1284,6785,10569,4020,9563,33662
252,"WORBIS","ERF",3712,1694,2172,477,13,24,8092,1917,2463,9839,9907,1006,6377,31509
253,"HEILIGENSTADT","ERF",2958,1052,1737,677,28,16,6468,1433,1660,8288,15619,2296,2968,32264
254,"MUHLHAUSEN LANDKREIS","ERF",3007,997,2298,671,17,13,7003,1808,2243,13049,12484,1394,3832,34810
255,"LANGENSALZA","ERF",1837,853,2335,690,20,22,5757,877,1240,11428,12211,1346,5266,32368
256,"WEISSENSEE","ERF",2252,857,1518,432,23,26,5108,938,1258,7181,8214,1958,7477,27026
257,"ERFURT STADTKREIS","ERF",131,62,95,50,4,0,342,47,87,513,1254,268,0,2169
258,"ERFURT LANDKREIS","ERF",1397,603,1619,668,10,8,4305,595,865,8239,11322,693,1368,23082
259,"ZIEGENRUCK","ERF",1048,335,737,299,11,4,2434,526,564,5261,7842,1494,1057,16744
260,"SCHLEUSINGEN","ERF",3791,1305,1446,170,3,5,6720,1648,1980,6937,2960,376,1079,14980
261,"HADERSLEBEN","SCH",2070,485,2489,2503,616,146,8309,395,850,14626,68640,47896,22520,154927
262,"APENRADE","SCH",648,223,931,1045,260,44,3151,148,378,5343,29777,19504,7994,63144
263,"SONDERBURG","SCH",1221,504,1037,1084,40,10,3896,235,787,4648,29325,2640,2424,40059
264,"FLENSBURG LANDKREIS","SCH",2300,702,2099,1783,240,34,7158,408,1270,11972,54525,20125,6477,94777
265,"SCHLESWIG","SCH",1853,739,2398,1886,319,29,7224,420,1233,12682,50604,22926,4900,92765
266,"ECKERNFORDE","SCH",2378,565,966,958,112,102,5081,613,1065,4649,26356,7561,30583,70827
267,"EIDERSTEDT","SCH",1583,222,543,416,96,20,2880,360,425,2798,10629,6444,2716,23372
268,"HUSUM","SCH",1302,545,1552,1560,206,22,5187,432,941,9336,43972,16291,2963,73935
269,"TONDERN","SCH",1966,971,3529,2404,580,127,9577,932,1818,21935,64102,45010,19448,153245
270,"OLDENBURG","SCH",5476,1064,834,845,181,85,8485,1045,1557,3612,26133,11928,29478,73753
271,"PLON","SCH",6040,750,843,863,192,92,8780,937,1253,4712,26942,12530,35226,81600
272,"KIEL STADTKREIS","SCH",2055,15,62,10,1,1,2144,136,24,244,197,91,190,882
273,"KIEL LANDKREIS","SCH",1895,356,643,799,289,39,4021,553,625,3306,23551,23479,10282,61796
274,"RENDSBURG","SCH",2558,540,1716,1461,428,66,6769,637,1008,9741,45622,36195,16253,109456
275,"NORDERDITHMARSCHEN","SCH",2327,466,1285,941,225,19,5263,628,782,6584,24521,15351,3718,51584
276,"SUDERDITHMARSCHEN","SCH",2142,525,1492,1228,269,23,5679,695,835,7828,33441,18916,3190,64905
277,"STEINBURG","SCH",3500,427,1084,1662,215,25,6913,938,699,5560,49647,17774,5317,79935
278,"SEGEBERG","SCH",4447,546,1070,982,478,84,7607,1069,822,6234,30022,39556,23309,101012
279,"STORMARN","SCH",8328,465,1014,1378,297,59,11541,1278,784,5670,38210,20017,17279,83238
280,"PINNEBERG","SCH",5163,491,1078,1464,135,18,8349,1306,1007,7134,41158,10256,4778,65639
281,"ALTONA STADTKREIS","SCH",277,21,35,8,2,0,343,40,30,155,225,146,0,596
282,"LAUENBURG","SCH",5757,508,916,1296,243,56,8776,1328,1190,5032,41439,18423,24871,92283
283,"DIEPHOLZ","HAN",1712,2216,3701,1750,27,3,9409,983,3868,29089,67728,3055,583,105306
284,"HOYA","HAN",2150,1962,2939,1254,40,14,8359,1116,3177,16951,36241,3107,2457,63049
285,"NIENBURG","HAN",2608,1738,3342,1458,39,12,9197,1429,3016,22491,44225,3465,2724,77350
286,"HANNOVER STADTKREIS","HAN",1000,85,131,4,1,0,1221,213,122,498,172,77,0,1082
287,"HANNOVER LANDKREIS","HAN",6416,1557,2787,1335,42,22,12159,2522,2338,17851,39552,3274,5525,71062
288,"WENNIGSEN","HAN",6317,869,1675,820,32,32,9745,2335,1324,8034,18146,2414,8837,41090
289,"HAMELN","HAN",5857,871,1521,947,22,20,9238,2034,1286,7793,20077,1428,5663,38281
290,"HILDESHEIM LANDKREIS","HIL",5352,1135,2103,886,53,24,9553,1849,1782,10372,19817,3551,5876,43247
291,"MARIENBURG","HIL",6632,941,1810,904,62,33,10382,2781,1748,11843,20809,4611,10015,51807
292,"LIEBENBURG","HIL",6879,593,1068,770,80,36,9426,2566,1219,6949,20101,5168,12133,48136
293,"OSTERODE AM HARZ","HIL",6069,2254,3112,812,14,12,12273,2703,3373,14953,14430,926,3054,39439
294,"GOTTINGEN LANDKREIS","HIL",5774,1617,2575,891,40,37,10934,2162,2464,12112,17631,3823,8727,46919
295,"EINBECK","HIL",6417,1648,2821,962,37,35,11920,2382,2453,13608,19771,2759,12013,52986
296,"ZELLERFELD","HIL",3362,1043,987,182,3,7,5584,1238,1494,4380,3271,225,1457,12065
297,"CELLE LANDKREIS","LUN",4608,1706,2742,2075,138,16,11285,2032,2720,18663,91535,20113,5913,140976
298,"GIFHORN","LUN",2588,2241,3386,1795,117,28,10155,1533,3471,21568,88986,12202,8224,135984
299,"FALLINGBOSTEL","LUN",3060,2000,2914,1525,163,19,9681,1766,3630,24510,120502,38912,5439,194759
300,"ULZEN","LUN",3922,1565,1238,1420,150,34,8329,1944,2312,9046,78494,19976,8344,120116
301,"DANNENBERG","LUN",4085,1998,2549,2238,49,23,10942,1903,2840,14590,66611,4787,12547,103278
302,"LUNEBURG LANDKREIS","LUN",3213,1583,1410,918,198,46,7368,1333,2290,7056,36870,23398,12895,83842
303,"HARBURG LANDKREIS","LUN",3357,2053,2693,1478,153,15,9749,1438,3193,17246,73546,19349,5159,119931
304,"STADER MARSCHKREIS","STA",4222,537,921,639,133,29,6481,944,863,4627,16740,10048,4376,37598
305,"STADER GEESTKREIS","STA",2113,1404,3296,1165,84,10,8072,1056,3758,29046,62068,10948,2218,109094
306,"NEUHAUS","STA",2159,665,1391,737,85,9,5046,763,1279,9934,22508,6272,2205,42961
307,"OTTERNDORF","STA",1441,415,703,501,109,11,3180,388,683,3708,12579,7602,1315,26275
308,"LEHE","STA",3661,867,2285,1696,93,19,8621,1910,2376,21058,59526,7916,3709,96495
309,"OSTERHOLZ","STA",3696,1067,2150,768,44,9,7734,1938,3137,18535,24490,4079,1783,53962
310,"VERDEN","STA",2390,1239,2453,854,31,3,6970,1121,2206,15609,32408,2624,468,54436
311,"ROTENBURG","STA",686,806,3037,1302,53,8,5892,466,1946,28004,85943,6348,2372,125079
312,"MEPPEN","OSN",3042,1980,4406,1289,25,6,10748,2105,5651,42176,57784,2564,1230,111510
313,"LINGEN","OSN",3164,1967,3967,1545,33,3,10679,1653,5046,37640,67141,2726,1043,115249
314,"BERSENBRUCK","OSN",1555,1861,3213,1289,13,2,7933,655,3359,20160,48119,2138,657,75088
315,"OSNABRUCK LANDKREIS","OSN",5106,1965,3132,822,10,3,11038,1581,3467,17058,25485,1407,1093,50091
316,"MELLE","OSN",2492,2768,2538,862,4,1,8665,1342,4486,14790,24247,312,184,45361
317,"AURICH","AUR",4157,1729,3956,1877,178,14,11911,1662,3153,22706,53016,11396,2465,94398
318,"EMDEN LANDKREIS","AUR",4562,833,1021,689,357,23,7485,1138,1284,4341,23679,22483,3376,56301
319,"LEER","AUR",5881,1564,2541,1229,155,5,11375,2715,3489,14023,36373,10991,809,68400
320,"TECKLENBURG","MUN",1864,2298,2902,844,13,2,7923,1043,4687,21776,31490,1540,894,61430
321,"WARENDORF","MUN",1452,1043,1744,797,52,2,5090,673,1840,11838,28640,4676,766,48433
322,"BECKUM","MUN",2809,918,1871,1044,191,18,6851,1124,1387,9214,31028,14907,2620,60280
323,"LUDINGHAUSEN","MUN",2282,1185,1647,1101,149,13,6377,1011,1766,7481,32721,11479,3482,57940
324,"MUNSTER STADTKREIS","MUN",691,89,73,13,2,0,868,162,127,298,304,406,0,1297
325,"MUNSTER LANDKREIS","MUN",1784,1074,1986,1270,124,8,6246,823,1885,11666,45630,10430,1410,71844
326,"STEINFURT","MUN",3283,1704,2415,889,55,4,8350,1525,3604,17263,34255,5190,805,62642
327,"KOESFELD","MUN",2671,1125,2098,1046,56,6,7002,1069,1966,13586,35489,4629,1257,57996
328,"AHAUS","MUN",1816,1460,2369,694,11,4,6354,1160,3428,16259,23975,990,2019,47831
329,"BORKEN","MUN",2681,1164,2317,768,5,1,6936,1200,2383,18776,27575,434,1000,51368
330,"RECKLINGHAUSEN LANDKREIS","MUN",5334,1464,2097,1079,39,1,10014,1860,2739,13767,34301,5390,976,59033
331,"MINDEN","MIN",5597,1845,3288,1082,8,11,11831,2243,2867,17692,22199,716,2381,48098
332,"LUBBECKE","MIN",2411,2070,3114,816,4,4,8419,1559,3675,20332,20218,403,1568,47755
333,"HERFORD","MIN",6289,2977,2798,802,12,5,12883,2477,4023,13018,17988,1138,1052,39696
334,"HALLE","MIN",1490,1757,1428,464,6,2,5147,734,2796,8287,13802,937,447,27003
335,"BIELEFELD STADTKREIS","MIN",2715,125,71,8,0,0,2919,488,175,269,198,0,0,1130
336,"BIELEFELD LANDKREIS","MIN",3788,1888,955,305,18,1,6955,1675,2747,5960,10926,1998,129,23435
337,"WIEDENBRUCK","MIN",2883,1938,2165,671,46,4,7707,1392,3148,12184,21844,5885,549,45002
338,"PADERBORN","MIN",2257,1303,1591,697,50,6,5904,1141,2563,12755,20929,3624,2410,43422
339,"BUREN","MIN",2038,1193,1750,1139,42,20,6182,977,1840,9454,24893,3654,8664,49482
340,"WARBURG","MIN",2285,700,1170,816,26,34,5031,960,1004,5896,16831,1846,9228,35765
341,"HOXTER","MIN",4584,1409,1852,960,32,35,8872,2048,2097,8576,21031,2421,8577,44750
342,"ARNSBERG","ARN",3479,916,1401,517,35,12,6360,1605,1922,11306,19008,3777,5128,42746
343,"MESCHEDE","ARN",2076,1110,1638,711,73,15,5623,1072,2117,12283,31552,9083,3613,59720
344,"BRILON","ARN",2559,1258,2458,668,8,11,6962,1172,2205,15185,14577,1677,3742,38558
345,"LIPPSTADT","ARN",2758,672,1325,845,73,16,5689,1013,1014,6825,19102,5600,4909,38463
346,"SOEST","ARN",4843,765,1742,927,78,10,8365,1531,1241,8297,24456,6861,2123,44509
347,"HAMM LANDKREIS","ARN",6223,917,1814,853,65,12,9884,1571,1382,8681,21640,5405,2599,41278
348,"DORTMUND STADTKREIS","ARN",4890,58,71,21,0,0,5040,408,80,320,395,0,0,1203
349,"DORTMUND LANDKREIS","ARN",15657,1202,1227,797,26,7,18916,3084,1877,5963,20146,3195,1457,35722
350,"BOCHUM STADTKREIS","ARN",1689,17,11,2,0,0,1719,161,24,35,61,0,0,281
351,"BOCHUM LANDKREIS","ARN",24057,1259,1124,605,20,1,27066,3637,2133,6337,16390,1591,102,30190
352,"HAGEN LANDKREIS","ARN",15165,1231,1706,450,11,2,18565,2666,2795,13910,14121,1533,412,35437
353,"ISERLOHN","ARN",6627,799,804,331,25,5,8591,1780,1883,5734,12745,2644,1908,26694
354,"ALTENA","ARN",4696,861,2439,698,5,2,8701,1691,2530,26210,24986,794,597,56808
355,"OLPE","ARN",2295,1001,1935,357,9,0,5597,1602,2995,25354,16732,840,0,47523
356,"SIEGEN","ARN",6487,2139,2173,42,1,0,10842,5723,10098,23363,1175,90,0,40449
357,"WITTGENSTEIN","ARN",1024,692,1286,224,0,2,3228,721,1476,10868,5607,0,25684,44356
358,"KASSEL STADTKREIS","KAS",333,37,50,12,2,1,435,92,68,216,361,262,121,1120
359,"KASSEL LANDKREIS","KAS",4056,949,1266,432,24,12,6739,1746,1427,5918,8022,1730,2774,21617
360,"ESCHWEGE","KAS",3704,1142,1845,496,21,27,7235,1741,1967,9825,11731,1802,6973,34039
361,"FRITZLAR","KAS",1940,616,1096,496,27,14,4189,876,914,5314,10519,1952,2116,21691
362,"HOFGEISMAR","KAS",2652,1207,2025,530,20,18,6452,1258,1758,8979,9716,1355,4748,27814
363,"HOMBERG","KAS",1550,456,911,551,14,11,3493,684,703,4593,10694,1122,2573,20369
364,"MELSUNGEN","KAS",2082,827,1057,512,16,8,4502,921,1214,4883,10646,1270,1504,20438
365,"ROTENBURG","KAS",2097,822,1280,624,20,24,4867,1031,1241,6197,13399,1679,4506,28053
366,"WITZENHAUSEN","KAS",2816,978,1212,265,21,24,5316,1260,1516,6152,5838,1681,4546,20993
367,"WOLFHAGEN","KAS",1634,722,1528,534,11,14,4443,726,1041,8239,12352,806,2990,26154
368,"MARBURG","KAS",2111,558,1605,825,15,6,5120,845,923,9522,18534,1218,914,31956
369,"FRANKENBERG","KAS",1086,646,1672,547,5,9,3965,529,988,8511,9815,364,2007,22214
370,"KIRCHHAIN","KAS",1557,571,1214,446,9,3,3800,697,851,6087,7642,639,438,16354
371,"ZIEGENHAIN","KAS",2159,753,1556,893,9,13,5383,950,1126,7777,17837,571,2897,31158
372,"FULDA","KAS",1539,851,2030,1093,12,13,5538,837,1507,11755,23853,1040,2686,41678
373,"HERSFELD","KAS",2141,900,1249,639,21,13,4963,915,1338,6079,12959,1650,2000,24941
374,"HUNFELD","KAS",1183,537,1109,855,11,6,3701,587,985,6674,18974,925,1998,30143
375,"HANAU LANDKREIS","KAS",2990,1004,2486,331,11,9,6831,1194,1463,11217,5291,1264,1952,22381
376,"GELNHAUSEN","KAS",2648,1267,2724,368,5,10,7022,1221,1920,12626,6511,998,5391,28667
377,"SCHLUCHTERN","KAS",1481,710,1615,692,9,6,4513,684,1054,7538,13618,690,1144,24728
378,"SCHMALKALDEN","KAS",2720,980,1095,128,7,3,4933,1257,1479,5379,2477,603,375,11570
379,"RINTELN","KAS",4030,1103,1377,623,15,13,7161,1586,1648,6165,13486,1151,2965,27001
380,"GERSFELD","KAS",760,453,1462,581,2,2,3260,404,769,8670,10950,193,710,21696
381,"DILLKREIS","WIE",2289,1688,2826,83,1,0,6887,1073,3246,14751,1802,245,0,21117
382,"OBERWESTERWALDKREIS","WIE",1427,1369,3714,172,7,1,6690,660,2052,16326,2869,883,104,22894
383,"UNTERWESTERWALDKREIS","WIE",3353,1818,4189,134,5,3,9502,1506,2931,22546,1963,379,393,29718
384,"OBERLAHNKREIS","WIE",3586,1513,3692,295,3,1,9090,1433,2218,21484,5525,203,215,31078
385,"UNTERLAHNKREIS","WIE",5162,1653,4133,478,9,1,11436,1761,2464,19668,7649,639,135,32316
386,"RHEINGAUKREIS","WIE",5809,1652,2120,220,5,3,9809,2284,2467,9188,4436,660,578,19613
387,"WIESBADEN STADTKREIS","WIE",289,40,69,28,1,1,428,104,55,330,1675,100,538,2802
388,"WIESBADEN LANDKREIS","WIE",3705,1063,2603,414,9,3,7797,1446,1651,12354,6274,1085,671,23481
389,"OBERTAUNUSKREIS","WIE",3318,1264,3084,228,3,4,7901,1369,1959,13876,3430,161,480,21275
390,"UNTERTAUNUSKREIS","WIE",2514,1303,3467,336,2,2,7624,1053,1968,16481,4730,135,269,24636
391,"FRANKFURT LANDKREIS","WIE",1044,211,166,47,6,8,1482,406,287,747,850,426,1181,3897
392,"BIEDENKOPF","WIE",2293,1171,2974,421,2,1,6862,1088,1921,15552,8105,161,141,26968
393,"KOBLENZ LANDKREIS","KOB",4465,1223,1753,156,4,1,7602,1808,1923,7694,2956,278,201,14860
394,"SANKT GOAR","KOB",2800,1515,2544,86,1,0,6946,1382,2433,11665,1366,73,0,16919
395,"KREUZNACH","KOB",4269,1620,3205,375,1,0,9470,1705,2398,14620,5917,350,0,24990
396,"SIMMERN","KOB",1448,1069,3568,366,4,1,6456,711,2278,20825,8096,972,755,33637
397,"ZELL","KOB",2972,1427,1697,110,0,0,6206,1529,2176,7280,1435,0,0,12420
398,"KOCHEM","KOB",3043,1330,2488,240,4,0,7105,1391,2329,15279,5824,308,0,25131
399,"MAYEN","KOB",4066,1381,3371,703,14,2,9537,1742,2220,17808,12402,993,692,35857
400,"ADENAU","KOB",1004,928,2141,210,1,1,4285,647,1792,12003,4173,72,130,18817
401,"AHRWEILER","KOB",3314,1264,1922,150,4,2,6656,2161,2894,11342,3258,249,403,20307
402,"NEUWIED","KOB",5699,1912,3723,226,5,2,11567,3029,3704,19503,4797,480,679,32192
403,"ALTENKIRCHEN","KOB",4458,1627,2505,277,3,0,8870,2335,3811,16172,6600,207,0,29125
404,"WETZLAR","KOB",2827,1307,3615,165,2,3,7919,1164,1898,19940,3651,140,3539,30332
405,"MEISENHEIM","KOB",712,346,1270,202,0,0,2530,301,568,7327,3207,0,0,11403
406,"KLEVE","DUS",3534,1173,1122,858,75,5,6767,1278,1780,5532,21030,5137,971,35728
407,"REES","DUS",2941,1096,1463,663,68,9,6240,1302,1924,10056,20418,5175,1292,40167
408,"KREFELD STADTKREIS","DUS",663,40,39,43,0,0,785,114,140,232,930,0,0,1416
409,"KREFELD LANDKREIS","DUS",3008,305,590,407,13,0,4323,650,473,3043,8782,816,0,13764
410,"DUISBURG","DUS",2072,52,98,27,1,0,2250,320,75,515,566,76,0,1552
411,"MULHEIM AN DER RUHR","DUS",9973,1166,1381,629,16,1,13166,2652,1921,7687,17209,1552,202,31223
412,"ESSEN STADTKREIS","DUS",1444,16,7,0,0,0,1467,151,22,30,0,0,0,203
413,"ESSEN LANDKREIS","DUS",15951,520,439,359,9,2,17280,2535,859,2241,9864,924,392,16815
414,"MORS","DUS",5441,1408,2088,1165,43,11,10156,2110,2163,10347,27586,3161,2545,47912
415,"GELDERN","DUS",4833,1031,1806,996,2,0,8668,1878,1865,12106,26600,122,0,42571
416,"KEMPEN","DUS",7912,860,1629,769,1,0,11171,2041,1618,10880,15014,129,0,29682
417,"DUSSELDORF STADTKREIS","DUS",1179,297,216,35,2,0,1729,344,429,944,746,158,0,2621
418,"DUSSELDORF LANDKREIS","DUS",5621,657,883,558,56,8,7783,1402,1056,4551,14152,3806,2451,27418
419,"ELBERFELD","DUS",1896,51,129,28,0,0,2104,239,105,868,560,0,0,1772
420,"BARMEN","DUS",3977,68,108,10,1,0,4164,302,131,629,164,53,0,1279
421,"METTMANN","DUS",8676,479,793,546,22,0,10516,1171,942,4683,13887,1651,0,22334
422,"LENNEP","DUS",9837,789,1767,297,2,0,12692,1805,2016,15317,7848,166,0,27152
423,"SOLINGEN LANDKREIS","DUS",9634,1370,1757,237,17,3,13018,2600,2585,9767,5832,1315,383,22482
424,"NEUSS","DUS",2794,754,1502,376,50,18,5494,1023,1121,7811,7146,3446,2751,23298
425,"GREVENBROICH","DUS",4222,670,1185,347,38,10,6472,1453,993,6145,7111,2577,1278,19557
426,"GLADBACH","DUS",7693,844,1528,257,7,1,10330,1976,1427,8687,4658,662,453,17863
427,"WIPPERFURTH","KOL",2249,651,1697,351,4,1,4953,727,1658,14915,8848,398,390,26936
428,"WALDBROL","KOL",1476,912,1863,158,0,0,4409,1174,2436,14116,3942,0,0,21668
429,"GUMMERSBACH","KOL",2025,1320,2300,111,0,0,5756,1428,3650,17377,3501,0,0,25956
430,"SIEGKREIS","KOL",7837,2546,4595,532,23,5,15538,4058,6067,29469,13712,1934,776,56016
431,"MULHEIM RHEIN LANDKREIS","KOL",5555,1305,1751,268,24,9,8912,2276,3515,11782,6458,2373,1245,27649
432,"KOLN STADTKREIS","KOL",84,36,45,4,0,1,170,106,47,190,153,0,450,946
433,"KOLN LANDKREIS","KOL",6281,1273,1767,377,104,30,9832,2357,1835,8854,7775,7738,4022,32581
434,"BERGHEIM","KOL",4206,843,1592,458,79,15,7193,1379,1242,8117,9907,5458,3616,29719
435,"EUSKIRCHEN","KOL",3482,795,1646,481,51,17,6472,1350,1187,11157,11196,4080,2650,31620
436,"RHEINBACH","KOL",2765,890,1810,398,18,6,5887,1496,1748,11426,8696,1380,1070,25816
437,"BONN LANDKREIS","KOL",5221,1320,1364,199,26,7,8137,2358,2551,7093,4196,1927,1048,19173
438,"DAUN","TRI",1104,733,2716,488,5,0,5046,516,1267,14701,8449,469,0,25402
439,"PRUM","TRI",1929,1042,2370,845,12,2,6200,1241,2431,22165,28129,1061,511,55538
440,"BITBURG","TRI",2370,1277,2660,1165,71,6,7549,1100,2023,14374,32288,7103,1232,58120
441,"WITTLICH","TRI",1875,1381,3205,397,12,3,6873,963,2235,15403,6642,1134,693,27070
442,"BERNKASTEL","TRI",3278,1970,3259,208,2,0,8717,1490,3049,13980,3748,425,0,22692
443,"TRIER STADTKREIS","TRI",858,269,325,17,3,5,1477,301,443,1879,313,294,5125,8355
444,"TRIER LANDKREIS","TRI",3190,2228,5028,556,13,3,11018,1647,3564,24938,9912,1603,594,42258
445,"SAARBURG","TRI",1254,1089,2327,407,11,0,5088,730,1828,12654,7737,845,0,23794
446,"MERZIG","TRI",2602,1176,2350,392,4,5,6529,1135,1916,13031,8206,430,1113,25831
447,"SAARLOUIS","TRI",4207,1834,3034,485,3,4,9567,1951,2651,13883,8173,262,823,27743
448,"SAARBRUCKEN","TRI",7895,1504,1693,232,5,2,11331,2392,2190,7511,3697,424,340,16554
449,"OTTWEILER","TRI",4281,1206,2174,251,0,3,7915,1333,1747,9690,3854,0,817,17441
450,"SANKT WENDEL","TRI",1825,1191,3549,568,2,1,7136,794,1845,21451,9452,264,313,34119
451,"ERKELENZ","AAC",3995,836,1818,375,13,2,7039,1402,1466,11314,8315,942,248,23687
452,"HEINSBERG","AAC",2864,1495,2281,171,2,0,6813,1222,2441,10900,3268,428,0,18259
453,"GEILENKIRCHEN","AAC",2125,794,1458,200,18,2,4597,768,1224,7130,3672,1281,282,14357
454,"JULICH","AAC",3244,868,1763,429,47,6,6357,1058,1270,9185,7814,3368,819,23514
455,"DUREN","AAC",5014,1224,2204,612,60,25,9139,1736,1903,12549,12137,4677,3673,36675
456,"AACHEN STADTKREIS","AAC",74,20,108,30,1,0,233,28,33,540,593,58,0,1252
457,"AACHEN LANDKREIS","AAC",6631,1039,1452,365,33,4,9524,1559,1594,7001,8109,2337,504,21104
458,"EUPEN","AAC",543,247,550,274,1,0,1615,193,381,2735,5354,68,0,8731
459,"MONTJOIE","AAC",1119,747,1608,95,1,0,3570,477,1196,7467,1397,123,0,10660
460,"SCHLEIDEN","AAC",2618,1246,3247,620,14,2,7747,1499,2408,21252,4869,1230,275,41533
461,"MALMEDY","AAC",1109,784,2771,595,10,0,5269,797,1814,20010,14263,1336,0,38220
462,"SIGMARINGEN","SIG",860,274,1166,625,15,2,2942,293,459,7444,13873,1773,434,24276
463,"GAMMERTINGEN","SIG",464,344,1432,575,3,2,2820,280,600,8159,10280,194,572,20085
464,"HECHINGEN","SIG",954,927,2000,59,3,3,3946,525,1519,8795,901,235,485,12460
465,"HAIGERLOCH","SIG",582,445,1409,61,4,3,2504,462,765,6223,1428,371,376,9625
